邪魔者 -> 煩わしい者
幸か不幸か -> ありがたいことに/不幸にも
フルカラー -> 豊かな色彩
バーコード -> 棒線画
卓球 -> 球技
ト音記号 -> トレブルクレフ
家族団欒 -> ほっこりする家族の時間
鳥居 -> 神聖な門
最終章 -> エピローグ
何度でも -> 繰り返し
先頭集団 -> リーダーたちの集まり
ハザードランプ -> 警告灯
いないいないばあ -> かくれんぼ
千円札 -> 一万円札
期待値 -> 期待する値
辞世の句 -> 余命を悟って詠んだ詩
缶コーヒー -> 缶詰めのコーヒー
シャンパンタワー -> 煌びやかなシャンパンの塔
袴 -> はかま
獣 -> 野獣
詰む -> 行き詰まる
分類 -> 分ける
天井 -> 上限
キャラメル -> とろけるキャンディー
学校制服 -> 共通の服装
かまぼこ -> かまぼこ型の食べ物
寝ぼけ -> 眠りから覚めたての状態
仮想通貨 -> デジタルマネー
出揃う -> 一堂に会する
いぶし銀 -> しゃれこうべ
破裂音 -> はれつおん
サンプル -> 見本
もんじゃ焼き -> 下町グルメ
初日の出 -> 初陽
答案 -> 解答
石油王 -> 石油バロン
月 -> 月影
習字 -> 書道
平成 -> あの時代
筋肉 -> 腕前
目安箱 -> 投書箱
磨りガラス -> ぼかしガラス
うちわ -> 扇子
熱い -> 燃えるような
聞き覚え -> 耳に馴染む
大聖堂 -> ゴシック建築
月 -> 月下美人
大渋滞 -> 渋滞地獄
かじかんだ手 -> 冷え切った手
低身長 -> 小柄な身長
定期考査 -> 定期試験
河原 -> 川岸
外国語 -> 異国の言葉
注入 -> 送り込む
チュートリアル -> 初歩講座
シャワー -> 雨のように降る
お約束 -> 王道の展開
クレーター -> 陥没穴
三角形 -> 三辺形
電話帳 -> 電話簿
紅葉狩り -> 秋の風物詩
ココナッツ -> 椰子の実
釣り合う -> バランスが取れる
地球規模 -> 地球の広がり
座右の銘 -> 心に留める言葉
運動会 -> 学校祭
心配性 -> 不安定な性格
焼きうどん -> 庶民的な料理
臓器 -> 内臓
絶滅危惧種 -> 絶滅危惧動物
良心 -> 良識
気象レーダー -> 天気予報
トラベラー -> 旅人
意地っ張り -> 頑固者
助ける -> 手を差し伸べる
紙 -> 薄い素材
エビ -> 海の宝石
わかめ -> 海の緑茶
ミートボール -> 肉団子
カツサンド -> 揚げたてサンドイッチ
コテージ -> 山小屋
限りある -> 果てしない
ライフセーバー -> 救命士
酔っぱらい -> 飲み
体罰 -> 殴り込み
電子タバコ -> 電子煙草
急転直下 -> 一気落ち
大人気 -> 大盛況
トカゲ -> 蜥蜴
脳震盪 -> 頭蓋振動
睡眠薬 -> 眠り薬
勝ち抜き -> 生き残り
狐 -> きつね
草食系男子 -> 草食男子
花鳥風月 -> 風月詩情
砂丘 -> 砂の丘
歌手 -> 声楽家
テクノロジー -> 技術革新
不合格 -> 落第
牧場 -> 牧野
一年後 -> 未来の一年
夜通し -> 明け方まで
竜王戦 -> 王者の闘い
隔離 -> 孤独な孤立
石包丁 -> 刃こぼれする刃物
大衆食堂 -> 人情味あふれる食堂
月 -> 月影
テレビ -> 銀の箱
定食屋 -> 食堂の風情
部屋掃除 -> 片付けの時間
羽ばたく -> 空高く舞う
音楽理論 -> 音楽の奥義
飲み直し -> 乾杯の再開
三角コーナー -> ハードな展開
ジンギスカン -> 草原の味覚
文明の利器 -> 便利な道具
影 -> 影絵のように
ほうき星 -> 流れ星
アルカリ性 -> 塩基性
妄想 -> 空想世界
脳みそ -> 思考回路
小さな変化 -> 些細な変化
終電を逃す -> 夜更けのロマンス
咳き込む -> 喉が詰まる
エクササイズ -> 健康への一歩
トナカイ -> サンタの仲間
境界線上 -> 境界線上の魔法
難易度 -> 難易度の高い課題
晩餐会 -> 華やかな晩餐
突沸 -> 沸騰の波
ストラップ -> ぶら下がる魅力
氷砂糖 -> きらめく砂糖
通知表 -> 成績表
生クリーム -> 濃厚なクリーム
好き勝手 -> 自由奔放
つま先 -> 足先の舞い
スタイリスト -> 時代を彩るスタイリスト
鋳型 -> 形作る鋳物
バラエティ番組 -> 多彩なエンターテインメント
進捗を生む -> 成果を生む
前奏曲 -> 前菜のような曲
保冷剤 -> 冷たい冷却剤
キーボード -> 手軽に弾ける鍵盤
オオカミ少年 -> 野性的な少年
貧困 -> 困難な状況
袴 -> 伝統的な袴姿
スーパーマーケット -> 大型店舗
破壊光線 -> 破壊の光
オールナイト -> 徹夜
キャリーバッグ -> 持ち運びバッグ
イヌ -> 犬
エチケット -> 礼儀作法
報告書 -> レポート
平成 -> 平成時代
集める -> 収集する
写真 -> 写真撮影
ミーアキャット -> ミーアキャット
ピアニスト -> ピアノ奏者
無礼講 -> 無礼講
ごちそうさま -> ご馳走様
会社 -> 企業
和洋折衷 -> 和風と洋風の融合
結婚式 -> 結婚の儀式
綿 -> 綿花
バッテリー -> 電池
インターハイ -> 高校生の運動会
大急ぎ -> 慌てて急ぐ
つば -> 帽子のつば
内臓 -> 内臓器官
事務所 -> オフィス
スプレー缶 -> スプレー缶
ベストアルバム -> ベスト盤
イチョウ -> イチョウの木
断る -> 断わる
忍法帖 -> 忍法の書
月曜日 -> 週の最初の日
流動体 -> 流体
哲学者 -> 哲学の専門家
天国 -> 天上界
狸寝入り -> 狸の寝床
消毒液 -> 除菌液
カバー -> 覆い
お通し -> 口直し
無味乾燥 -> 味気なくて乾いた
不協和音 -> 不協和な音
プラカード -> 看板
粗探し -> 粗いものを探す
観察力 -> 観察眼
差異 -> 相違点
ロックンロール -> 揺れ動く音楽
寒空 -> 凍りつくような空
不時着 -> 急着陸
おふざけ -> 冗談めかした振る舞い
インドゾウ -> アジアゾウ
馬 -> 雄大なる駿馬
危機感 -> 危機感覚
瓦割り -> 瓦を割る勇気
線香花火 -> 夜空に咲く線香花火
歌謡曲 -> 心に染みる歌謡曲
今年 -> 今春
吹き出物 -> にきび
振りまく -> 撒き散らす
愛の告白 -> 恋の宣言
蜘蛛の糸 -> 蜘蛛の巣
国会答弁 -> 議会での弁舌
水蒸気 -> 湯気
ペガサス -> 天馬
クラシック -> 古典音楽
相互 -> 互いに
砂 -> 砂粒
歌詞カード -> 歌詞のカード
付き合う -> 交際する
飽和 -> 飽和状態
磔 -> 十字架刑
電話帳 -> 電話番号簿
的外れ -> ターゲットミス
公開処刑 -> 公開の処刑
風呂上がり -> 入浴後
スカイチーム -> 空の連合
子供 -> こども
すまし顔 -> しとやかな顔
やらせ -> 演出
三途の川 -> 死者の川
伝統芸能 -> 伝統的な芸能
切る -> 切り離す
ウォーターフロント -> 水辺の地区
はとバス -> ツアーバス
野球中継 -> ベースボール中継
ピストン運動 -> ピストンの動き
アナクロ -> 時代遅れ
バオバブ -> バオバブの木
カミングアウト -> 自分の性的指向を公表すること
大都会 -> 大きな都市
セミ -> 蝉
ボンバーヘッド -> ボンバーヘッド (種類の魚)
企む -> 謀る
メソポタミア文明 -> 二河流域文明
銀行通帳 -> 預金通帳
千両箱 -> 金箱
トカゲ -> 蜥蜴
若葉マーク -> 新緑マーク
ロックバンド -> 音楽集団
操り人形 -> 糸操りの人形
ムー大陸 -> 失われた大陸
アライグマ -> 狸
面識 -> 相知れる
伝書鳩 -> 使い鳩
ダークファンタジー -> 黒い幻想
バク転土下座 -> 転ばぬ先の杖
耐震強度 -> 揺るぎない強度
打線 -> 打撃陣
事件 -> 事象
公式 -> 正式
ハッピーバースデー -> 誕生日おめでとう
時価総額 -> 株価総額
ホラー映画 -> 恐怖映画
寿司 -> 鮨
ヤマカガシ -> 山槛
魚雷 -> 魚雷
立ちん坊 -> 立ち小便
社会保障費 -> 社会保障経費
おはぎ -> おもち
子持ちししゃも -> 子持ちのししゃも
昼ごはん -> 昼食
眺め -> 眺める風景
飽和 -> 飽き足らず
NHKの集金 -> 受信料徴収
民族紛争 -> 民族間闘争
月 -> 月影
ヒロイン -> 主人公女性
音楽 -> 美しい旋律
干潟 -> 砂浜
ポーランド分割 -> ポーランドの分割
たくましい -> 強靭な
軍事政権 -> 軍事政府
レモネード -> 酸っぱいドリンク
太陽 -> 燦々と輝く
漢字テスト -> 漢字クイズ
迫害 -> 追い詰める苦しみ
三角形 -> 三角形の形状
惨殺 -> 残忍な殺人
旅カラス -> 放浪するカラス
木製バット -> 木のバット
花 -> 華やかな花々
笑止千万 -> 笑えないほど滑稽
音楽不況 -> 音楽業界の不況
コーディネート -> 調和のとれた配色
ロックオン -> 正確な標的を捕捉
無 -> 何もない、空っぽ
アジアゾウ -> アジアの象
インプット -> 入力
一人きり -> 孤独な一人
クラウド -> インターネット上のデータ保管場所
用心棒 -> 守り神、守り手
スイカ -> 甘い夏の果物
グラファイト -> 黒鉛
ソースコード -> コンピュータープログラムのソースコード
チキン南蛮 -> 鶏肉の南蛮漬け
光合成 -> 植物の光合成作用
買収 -> 権力者や企業を買収する
