生い立ち -> 育ち
うつ伏せ -> 腹這い
膝頭 -> 膝小僧
しじま -> 静寂
片腹痛い -> 馬鹿馬鹿しい
今後 -> これから
先般 -> あのとき
次に -> そして
あながち -> 必ずしも
なまじ -> なまじっか
やはり -> None
不利益 -> None
大まか -> 大雑把
叩き台 -> 案
交通費 -> 足代
ポケットマネー -> 自腹
資金繰り -> 金繰り
借財 -> None
お世話になりました -> None
霊園 -> 墓場
高齢者 -> 老人
塗りつける -> 塗りたくる
無心する -> せびる
乗る -> 乗っかる
探す -> あさる
疲れる -> へばる
こぼす -> 愚痴る
多忙 -> 忙しい
厚手 -> 厚ぼったい
多い -> しこたま
猫に小判 -> 豚に真珠
目算 -> 皮算用
理屈 -> 屁理屈
地面 -> 地べた
逃亡 -> とんずら
大笑い -> 馬鹿笑い
身元 -> 氏素性
素行 -> 身持ち
不意打ち -> だまし討ち
不合格 -> 落第
言い分 -> 言いぐさ
昼日中 -> 真っ昼間
不憫 -> 哀れ
うぶ -> おぼこい
ビギナー -> 初心者
ベテラン -> 古株
古狸 -> 古狐
奥様 -> 細君
緩慢 -> のろい
無口 -> 無愛想
かかる -> こうした
